W000WWWWWW
W100WWWWWW
00WWW0WWW0
011WW10W1W
11WWW00W1W
11100010W1
0WWWWWW0W1
0W000WW0W1
0W0W10W0W1
0W0WP0W0W1
0W10WWW0W1
0WW10000W1
0WWWWWWWW1
000000000W
W1WWWWWWW0
WW1WWWW00W
W011WW0W10
W0WWWWW0W1
WWWWWWW101
0000000000