WWWWWWWWWW
WWWWWWWWWW
WWPWWWWWWW
WW0WWWWWWW
WW0WWWWWWW
WW0WWWWWWW
WW0WWWWWWW
WW010000WW
WW0WWWW0WW
WW0WWWW0WW
WW0WWWW0WW
WW0WWWW0WW
WW000000WW
WWWWWWWWWW
WWWWWWWWWW
WWWWWWWWWW
WWWWWWWWWW
WWWWWWWWWW
WWWWWWWWWW
WWWWWWWWWW