P000000000
00WWWWWWW0
00WWWWWWW0
0W0WWWWWW0
0W0WWWWWW0
0W0WWWWWW0
0WW0WWWWW0
0WW0WWWWW0
0WW0WWWWW0
0WWW0WWWW0
0WWWW0WWW0
0WWWW0WWW0
0WWWW0WWW0
0WWWWW0WW0
0WWWWW0WW0
0WWWWW0WW0
0WWWWWW0W0
0WWWWWW0W0
0WWWWWWW00
0000000000