WWWWWWWWWW
WWWWWWWWWW
WWWWWWWWWW
WWWWWWWWWW
WWWWWWWWWW
WWWWW0WWWW
WWWW0W0WWW
WWWWW1WWWW
WWWW0W0WWW
WWW0WWW1WW
WWWW0W0W0W
WWWWW0WWWW
WWWWPWWWWW
WWWWWWWWWW
WWWWWWWWWW
WWWWWWWWWW
WWWWWWWWWW
WWWWWWWWWW
WWWWWWWWWW
WWWWWWWWWW