WWWWWWWWWW
WWWWWWWWWW
WWPWWWWWWW
WW0WWWWWWW
WW0WWWWWWW
WW0WWWWWWW
WW0WWWWWWW
WW100000WW
WW1WWWW0WW
WW1WWWW0WW
WW1WWWW0WW
WW1WWWW0WW
WW000000WW
WWW0W0WWWW
WWWW0WWWWW
WWWWWWWWWW
WWWWWWWWWW
WWWWWWWWWW
WWWWWWWWWW
WWWWWWWWWW