WWWWWWWWWW
WWWWWWWWWW
WWWWWWWWWW
WWWWWWWWWW
WWWWWWWWWW
WWWWWWWWWW
WW0WWWWWWW
WW1WWWWWWW
WW10010WWW
WW0WP0WWWW
WW0WW0WWWW
WW1WWWWWWW
WWW01WWWWW
WWWWW00WWW
WWWW110WWW
WWWW0W1WWW
WWWWW1WWWW
WWWWWWWWWW
WWWWWWWWWW
WWWWWWWWWW